359,358,359,358,359,358,359,358,359,270
271,2819,2820,2821,1,1,1,1,1,358
359,2907,4577,2909,1,1,1,1,1,270
271,2995,2996,2997,1,1,1,1,1,358
359,1,1,1,1,1,1,1,1,270
271,1,1,1,1,1,1,1,1,358
359,1,1,1,1,1,2819,2820,2821,270
271,1,1,1,1,1,2907,4577,2909,358
359,1,1,1,1,1,2995,2996,2997,270
271,270,271,270,271,270,271,270,271,358
